its	it's
dont	don't
im	i'm
thats	that's
youre	you're
ive	i've
didnt	didn't
doesnt	doesn't
cant	can't
hes	he's
isnt	isn't
theres	there's
theyre	they're
id	i'd
ill	i'll
shes	she's
wasnt	wasn't
wouldnt	wouldn't
arent	aren't
wont	won't
havent	haven't
whats	what's
youll	you'll
couldnt	couldn't
were	we're
lets	let's
youve	you've
shouldnt	shouldn't
youd	you'd
theyve	they've
theyll	they'll
hasnt	hasn't
heres	here's
itll	it'll
werent	weren't
wouldve	would've
whos	who's
weve	we've
aint	ain't
theyd	they'd
hed	he'd
hell	he'll
well	we'll
yall	y'all
todays	today's
couldve	could've
shouldve	should've
itd	it'd
hadnt	hadn't
someones	someone's
wheres	where's
womens	women's
everyones	everyone's
peoples	people's
shell	she'll
ops	op's
wed	we'd
shed	she'd
ones	one's
mans	man's
elses	else's
mens	men's
teams	team's
hows	how's
lebrons	lebron's
zhonglis	zhongli's
worlds	world's
kazuhas	kazuha's
mcdonalds	mcdonald's
syfen	sy'fen
americas	america's
as	a's
ayakas	ayaka's
ks	k's
bruces	bruce's
thatd	that'd
kokomis	kokomi's
players	player's
kobes	kobe's
guys	guy's
friends	friend's
years	year's
ventis	venti's
persons	person's
others	other's
cmon	c'mon
vancouvers	vancouver's
hulks	hulk's
pandoras	pandora's
kaisa	kai'sa
moms	mom's
dudes	dude's
raidens	raiden's
monas	mona's
womans	woman's
pigs	pig's
yesterdays	yesterday's
yoimiyas	yoimiya's
xiaos	xiao's
characters	character's
anyones	anyone's
games	game's
childes	childe's
riots	riot's
tchalla	t'challa
taos	tao's
ittos	itto's
leagues	league's
kds	kd's
ganyus	ganyu's
russias	russia's
drivers	driver's
jojos	jojo's
joes	joe's
os	o's
thors	thor's
dogs	dog's
yall	ya'll
weeks	week's
jordans	jordan's
eulas	eula's
adcs	adc's
jens	jen's
childrens	children's
brothers	brother's
kids	kid's
albedos	albedo's
kawhis	kawhi's
marvels	marvel's
sisters	sister's
bennetts	bennett's
sons	son's
chefs	chef's
belveth	bel'veth
smores	s'mores
currys	curry's
klees	klee's
ccd	cc'd
doctors	doctor's
gods	god's
assassins	assassin's
devils	devil's
yknow	y'know
childs	child's
dads	dad's
stephs	steph's
bobs	bob's
shaqs	shaq's
caesars	caesar's
dilucs	diluc's
watsons	watson's
girls	girl's
dravens	draven's
grandmas	grandma's
farmers	farmer's
piggys	piggy's
thralls	thrall's
wolfs	wolf's
heros	hero's
deaths	death's
banners	banner's
mothers	mother's
lions	lion's
steves	steve's
ludens	luden's
masters	master's
dirks	dirk's
mjs	mj's
mums	mum's
udyrs	udyr's
nfls	nfl's
lukas	luka's
chogath	cho'gath
lots	lot's
somethings	something's
opponents	opponent's
kyries	kyrie's
fathers	father's
mortdogs	mortdog's
titans	titan's
cats	cat's
partners	partner's
lifes	life's
sets	set's
kings	king's
champions	champion's
chogall	cho'gall
dragons	dragon's
knights	knight's
reksai	rek'sai
jeans	jean's
asols	asol's
rdls	rdl's
beginners	beginner's
landlords	landlord's
husbands	husband's
owners	owner's
ima	i'ma
boyfriends	boyfriend's
vets	vet's
archangels	archangel's
saudis	saudi's
mvps	mvp's
daughters	daughter's
cars	car's
isekaid	isekai'd
xinyans	xinyan's
keqings	keqing's
potatos	potato's
shits	shit's
nbas	nba's
shows	show's
peters	peter's
johns	john's
ambers	amber's
hardens	harden's
reeses	reese's
gets	get's
peanuts	peanut's
subreddits	subreddit's
ws	w's
cs	c's
authors	author's
whys	why's
cced	cc'ed
browns	brown's
qs	q's
namis	nami's
ls	l's
gps	gp's
smore	s'more
nights	night's
losers	loser's
dames	dame's
neekos	neeko's
zhonyas	zhonya's
grandmothers	grandmother's
units	unit's
bakers	baker's
lokis	loki's
khazix	kha'zix
daejas	daeja's
corkis	corki's
zzrot	zz'rot
winners	winner's
wilts	wilt's
xayahs	xayah's
peds	ped's
zions	zion's
dqd	dq'd
mines	mine's
birds	bird's
hunters	hunter's
kogmaw	kog'maw
velkoz	vel'koz
lords	lord's
westbrooks	westbrook's
seasons	season's
kitchens	kitchen's
runaans	runaan's
lees	lee's
bons	bon's
caps	cap's
summoners	summoner's
months	month's
thomas	thoma's
governments	government's
prs	pr's
dbs	db's
pirates	pirate's
confectioners	confectioner's
angels	angel's
tos	to's
govt	gov't
chucks	chuck's
bfs	bf's
animes	anime's
schools	school's
cooks	cook's
shins	shin's
moneys	money's
fakers	faker's
tigers	tiger's
accounts	account's
volis	voli's
jays	jay's
champs	champ's
bcs	bc's
neighbours	neighbour's
kgs	kg's
heavens	heaven's
brains	brain's
queens	queen's
piggies	piggie's
posts	post's
cores	core's
metas	meta's
quills	quill's
suvs	suv's
bros	bro's
hells	hell's
semis	semi's
guineas	guinea's
fans	fan's
sports	sport's
thiefs	thief's
gs	g's
victims	victim's
hrs	hr's
gfs	gf's
draymonds	draymond's
subs	sub's
rylais	rylai's
crohns	crohn's
cousins	cousin's
carries	carrie's
chinas	china's
pros	pro's
boards	board's
dosent	dosen't
rays	ray's
roses	rose's
giannis	gianni's
shepherds	shepherd's
names	name's
parents	parent's
tacticians	tactician's
idas	ida's
gargoyles	gargoyle's
lobbys	lobby's
guinsoos	guinsoo's
visions	vision's
mcs	mc's
yours	your's
presidents	president's
nephews	nephew's
grandpas	grandpa's
volibears	volibear's
heats	heat's
pitchers	pitcher's
sees	see's
dbacks	d'backs
executioners	executioner's
dcs	dc's
bills	bill's
es	e's
nashors	nashor's
vis	vi's
dpss	dps's
urarakas	uraraka's
starks	stark's
ccs	cc's
qbs	qb's
suits	suit's
stores	store's
ts	t's
parks	park's
fridays	friday's
prowlers	prowler's
travelers	traveler's
imma	i'mma
tds	td's
pajos	pajo's
states	state's
yones	yone's
adventurers	adventurer's
ads	ad's
americans	american's
phones	phone's
roommates	roommate's
trys	try's
days	day's
archons	archon's
wanderers	wanderer's
gamblers	gambler's
rats	rat's
nations	nation's
teachers	teacher's
suns	sun's
fbs	fb's
deads	dead's
apples	apple's
stans	stan's
razors	razor's
neighbors	neighbor's
js	j's
nas	na's
phils	phil's
bolts	bolt's
courts	court's
mls	ml's
mirages	mirage's
tfts	tft's
shivs	shiv's
astrals	astral's
monkeys	monkey's
books	book's
las	la's
dls	dl's
laws	law's
yasuos	yasuo's
jokes	joke's
devs	dev's
bis	bi's
dms	dm's
is	i's
lemons	lemon's
captains	captain's
users	user's
tuesdays	tuesday's
natures	nature's
lols	lol's
ants	ant's
timmies	timmie's
qiqis	qiqi's
times	time's
riders	rider's
dominos	domino's
theirs	their's
athletes	athlete's
ins	in's
ds	d's
writers	writer's
doms	dom's
rabadons	rabadon's
pets	pet's
trumps	trump's
adams	adam's
bards	bard's
autos	auto's
lowes	lowe's
judges	judge's
carrys	carry's
summers	summer's
thursdays	thursday's
orgs	org's
skins	skin's
ms	m's
warmogs	warmog's
morellos	morello's
vas	va's
nuggets	nugget's
boys	boy's
rescues	rescue's
animals	animal's
clients	client's
maidens	maiden's
cest	c'est
jacks	jack's
nats	nat's
sgps	sgp's
popeyes	popeye's
mornings	morning's
twins	twin's
coyotes	coyote's
fates	fate's
brands	brand's
uncles	uncle's
pcs	pc's
ovas	ova's
boars	boar's
universes	universe's
stars	star's
ashes	ashe's
ryzes	ryze's
warwicks	warwick's
members	member's
regions	region's
enclosures	enclosure's
pjs	pj's
goats	goat's
bachelors	bachelor's
things	thing's
astros	astro's
barbells	barbell's
lifters	lifter's
flys	fly's
generations	generation's
eras	era's
xs	x's
hands	hand's
loves	love's
payers	payer's
m&ms	m&m's
combos	combo's
